3 3 3 3 3 3 3 3 3 3 3 3 3 3 3 3 3 3 3 3 3 3 3 3 3 3 3 3 3 3 3 3 3 3 3 3 3 3 3 3 3 3 3 3 3 3 3 3 3 3 3 3 3 3 3 3 3 3 3 3 3 3 3 3 3 3 3 3 3 3 3 3 3 3 3 3 3 3 3 3 3 3 3 3 3 3 3 3 3 3 3 3 3 3 3 3 3 3 3 3 
3 3 3 3 3 3 3 3 3 3 3 3 3 3 3 3 3 3 3 3 3 3 3 3 3 3 3 3 3 3 3 3 3 3 3 3 3 3 3 3 3 3 3 3 3 3 3 3 3 3 3 3 3 3 3 3 3 3 3 3 3 3 3 3 3 3 3 3 3 3 3 3 3 3 3 3 3 3 3 3 3 3 3 3 3 3 3 3 3 3 3 3 3 3 3 3 3 3 3 3 
3 3 3 3 3 3 3 3 3 3 3 3 3 3 3 3 3 3 3 3 3 3 3 3 3 3 3 3 3 3 3 3 3 3 3 3 3 3 3 3 3 3 3 3 3 3 3 3 3 3 3 3 3 3 3 3 3 3 3 3 3 3 3 3 3 3 3 3 3 3 3 3 3 3 3 3 3 3 3 3 3 3 3 3 3 3 3 3 3 3 3 3 3 3 3 3 3 3 3 3 
3 3 3 3 3 3 3 3 3 3 3 3 3 3 3 3 3 3 3 3 3 3 3 3 3 3 3 3 3 3 3 3 3 3 3 3 3 3 3 3 3 3 3 3 3 3 3 3 3 3 3 3 3 3 3 3 3 3 3 3 3 3 3 3 3 3 3 3 3 3 3 3 3 3 3 3 3 3 3 3 3 3 3 3 3 3 3 3 3 3 3 3 3 3 3 3 3 3 3 3 
3 3 3 3 3 3 3 3 3 3 3 3 3 3 3 3 3 3 3 3 3 3 3 3 3 3 3 3 3 3 3 3 3 3 3 3 3 3 3 3 3 3 3 3 3 3 3 3 3 3 3 3 3 3 3 3 3 3 3 3 3 3 3 3 3 3 3 3 3 3 3 3 3 3 3 3 3 3 3 3 3 3 3 3 3 3 3 3 3 3 3 3 3 3 3 3 3 3 3 3 
3 3 3 3 3 3 3 3 3 3 3 3 3 3 3 3 3 3 3 3 3 3 3 3 3 3 3 3 3 3 3 3 3 3 3 3 3 3 3 3 3 3 3 3 3 3 3 3 3 3 3 3 3 3 3 3 3 3 3 3 3 3 3 3 3 3 3 3 3 3 3 3 3 3 3 3 3 3 3 3 3 3 3 3 3 3 3 3 3 3 3 3 3 3 3 3 3 3 3 3 
3 3 3 3 3 3 3 3 3 3 3 3 3 3 3 3 3 3 3 3 3 3 3 3 3 3 3 3 3 3 3 3 3 3 3 3 3 3 3 3 3 3 3 3 3 3 3 3 3 3 3 3 3 3 3 3 3 3 3 3 3 3 3 3 3 3 3 3 3 3 3 3 3 3 3 3 3 3 3 3 3 3 3 3 3 3 3 3 3 3 3 3 3 3 3 3 3 3 3 3 
3 3 3 3 3 3 3 3 3 3 3 3 3 3 32 13 13 13 13 13 13 13 13 13 13 13 13 13 13 13 13 13 13 13 13 13 13 13 13 13 13 13 13 13 13 13 13 13 13 13 13 13 13 13 13 13 13 13 13 13 13 13 13 13 13 13 13 13 13 13 13 13 13 13 13 13 13 13 13 13 13 13 13 13 13 33 3 3 3 3 3 3 3 3 3 3 3 3 3 3 
3 3 3 3 3 3 3 3 3 3 3 3 3 3 18 2 1 1 2 2 1 1 2 1 1 1 1 1 31 26 26 26 26 26 26 26 26 26 26 26 26 26 26 26 26 26 26 26 26 26 26 26 26 26 26 26 26 26 26 26 26 26 26 26 26 26 26 26 26 26 26 26 26 26 26 26 26 26 26 26 30 1 1 1 2 19 3 3 3 3 3 3 3 3 3 3 3 3 3 3 
3 3 3 3 3 3 3 3 3 3 3 3 3 3 18 2 1 1 1 1 1 2 1 1 1 2 2 1 24 6 6 6 6 6 6 6 6 6 6 6 6 6 6 6 6 6 6 6 6 6 6 6 6 6 6 6 6 6 6 6 6 6 6 6 6 6 6 6 6 6 6 6 6 6 6 6 6 6 6 6 21 1 2 1 1 19 3 3 3 3 3 3 3 3 3 3 3 3 3 3 
3 3 3 3 3 3 3 3 3 3 3 3 3 3 18 1 1 2 1 2 1 1 1 2 1 1 1 2 24 6 20 23 23 23 23 23 23 23 23 23 23 23 23 23 23 23 23 23 23 23 23 23 23 23 23 23 23 23 23 23 23 23 23 23 23 23 23 23 23 23 23 23 23 23 23 23 23 23 23 23 29 1 1 1 2 19 3 3 3 3 3 3 3 3 3 3 3 3 3 3 
3 3 3 3 3 3 3 3 3 3 3 3 3 3 18 5 1 5 5 5 5 5 5 5 5 5 5 5 24 6 21 14 12 12 12 12 12 12 12 12 12 12 12 12 12 12 12 12 12 12 12 12 16 5 5 5 5 5 5 5 5 5 5 5 5 5 5 5 5 5 5 5 5 5 5 5 5 5 5 5 5 5 5 5 1 19 3 3 3 3 3 3 3 3 3 3 3 3 3 3 
3 3 3 3 3 3 3 3 3 3 3 3 3 3 18 5 1 5 31 26 26 26 26 26 26 26 26 26 27 6 21 19 3 3 3 3 3 3 3 3 3 3 3 3 3 3 3 3 3 3 3 3 18 5 5 5 1 1 1 2 1 1 1 2 1 2 1 1 1 1 2 1 1 1 1 2 1 1 2 1 1 1 5 1 2 19 3 3 3 3 3 3 3 3 3 3 3 3 3 3 
3 3 3 3 3 3 3 3 3 3 3 3 3 3 18 5 1 5 24 6 6 6 6 6 6 6 6 6 6 6 21 19 3 3 3 3 3 3 3 3 3 3 3 3 3 3 3 3 3 3 3 3 18 5 5 5 2 1 1 1 2 2 1 1 1 1 1 1 1 2 1 2 1 1 1 1 1 1 1 1 1 1 5 1 1 19 3 3 3 3 3 3 3 3 3 3 3 3 3 3 
3 3 3 3 3 3 3 3 3 3 3 3 3 3 18 5 1 5 24 6 20 23 23 23 23 23 23 23 25 6 21 15 13 13 13 13 13 13 13 13 13 13 13 13 13 13 13 13 13 13 13 13 17 5 5 5 5 5 5 5 5 5 5 5 5 5 5 5 5 5 5 5 5 5 5 5 5 5 5 5 2 1 5 2 1 19 3 3 3 3 3 3 3 3 3 3 3 3 3 3 
3 3 3 3 3 3 3 3 3 3 3 3 3 3 18 5 1 5 24 6 21 5 5 5 5 5 5 5 24 6 22 26 26 26 26 26 26 26 26 26 26 26 26 26 26 26 26 26 26 26 26 26 26 26 26 26 26 26 26 26 26 26 26 26 26 26 26 26 26 26 26 26 26 26 26 26 26 26 26 26 30 2 5 1 1 19 3 3 3 3 3 3 3 3 3 3 3 3 3 3 
3 3 3 3 3 3 3 3 3 3 3 3 3 3 18 5 2 5 24 6 21 5 5 5 5 5 5 5 24 6 6 6 6 6 6 6 6 6 6 6 6 6 6 6 6 6 6 6 6 6 6 6 6 6 6 6 6 6 6 6 6 6 6 6 6 6 6 6 6 6 6 6 6 6 6 6 6 6 6 6 21 2 5 1 2 19 3 3 3 3 3 3 3 3 3 3 3 3 3 3 
3 3 3 3 3 3 3 3 3 3 3 3 3 3 18 5 1 5 24 6 21 5 5 5 5 5 5 5 28 23 23 23 23 23 23 23 23 23 23 23 23 23 23 23 23 23 23 23 23 23 23 23 23 23 23 23 23 23 23 23 23 23 23 23 23 23 23 23 23 23 23 23 23 23 23 23 23 23 23 23 29 1 5 1 1 19 3 3 3 3 3 3 3 3 3 3 3 3 3 3 
3 3 3 3 3 3 3 3 3 3 3 3 3 3 18 5 2 5 24 6 21 5 5 5 5 5 5 5 5 5 5 5 5 5 5 5 5 5 5 5 5 5 5 5 5 5 5 5 5 5 5 5 5 5 5 5 5 5 5 5 5 5 5 5 5 5 5 5 5 5 5 5 5 5 5 5 5 5 5 5 5 5 5 1 1 19 3 3 3 3 3 3 3 3 3 3 3 3 3 3 
3 3 3 3 3 3 3 3 3 3 3 3 3 3 18 5 1 5 24 6 21 5 5 5 5 5 5 5 5 5 5 5 5 5 5 5 5 5 5 5 5 5 5 5 5 5 5 5 5 5 5 5 5 5 5 5 5 5 5 5 5 5 5 5 5 5 1 1 1 1 2 1 1 1 1 1 1 2 1 1 1 1 1 2 1 19 3 3 3 3 3 3 3 3 3 3 3 3 3 3 
3 3 3 3 3 3 3 3 3 3 3 3 3 3 18 5 1 5 24 6 21 5 5 5 5 5 5 5 5 5 5 5 5 5 5 5 5 5 5 5 5 5 5 5 5 5 5 5 5 5 5 5 5 5 5 5 5 5 5 5 5 5 5 5 5 5 1 2 1 1 1 1 2 1 1 1 1 1 1 2 1 1 1 1 1 19 3 3 3 3 3 3 3 3 3 3 3 3 3 3 
3 3 3 3 3 3 3 3 3 3 3 3 3 3 18 5 1 5 24 6 21 5 5 5 5 5 5 5 5 5 5 5 5 5 5 5 5 5 5 5 5 5 5 5 5 5 5 5 5 5 5 5 5 5 5 5 5 5 5 5 5 5 5 5 5 5 1 1 1 1 1 1 1 1 1 2 1 1 1 1 1 1 2 1 1 19 3 3 3 3 3 3 3 3 3 3 3 3 3 3 
3 3 3 3 3 3 3 3 3 3 3 3 3 3 18 5 2 5 24 6 21 5 5 5 5 5 5 5 5 5 5 5 5 5 5 5 5 5 5 5 5 5 5 1 2 2 1 1 1 2 1 1 1 2 2 1 1 2 1 5 5 5 5 5 5 5 1 2 1 2 1 5 5 5 5 5 5 5 5 5 5 5 5 5 5 19 3 3 3 3 3 3 3 3 3 3 3 3 3 3 
3 3 3 3 3 3 3 3 3 3 3 3 3 3 18 5 1 5 24 6 22 26 26 26 26 26 26 26 26 26 26 26 26 26 26 26 26 26 26 26 26 26 26 26 26 26 26 26 26 26 26 26 26 26 26 26 30 1 2 5 5 5 5 5 5 5 1 1 1 1 1 5 5 5 5 5 5 5 5 5 5 5 5 5 5 19 3 3 3 3 3 3 3 3 3 3 3 3 3 3 
3 3 3 3 3 3 3 3 3 3 3 3 3 3 35 12 12 16 24 6 6 6 6 6 6 6 6 6 6 6 6 6 6 6 6 6 6 6 6 6 6 6 6 6 6 6 6 6 6 6 6 6 6 6 6 6 21 2 14 12 12 12 12 12 12 16 5 1 1 2 1 5 5 5 5 5 5 5 5 5 5 5 5 5 5 19 3 3 3 3 3 3 3 3 3 3 3 3 3 3 
3 3 3 3 3 3 3 3 3 3 3 3 3 3 3 3 3 18 24 6 20 23 23 23 23 23 23 23 23 23 23 23 23 23 23 23 23 23 23 23 23 23 23 23 23 23 23 23 23 23 23 23 23 23 23 23 29 1 19 3 3 3 3 3 3 18 5 1 1 2 1 5 5 5 5 5 5 5 5 5 5 5 5 5 5 19 3 3 3 3 3 3 3 3 3 3 3 3 3 3 
3 3 3 3 3 3 3 3 3 3 3 3 3 3 3 3 3 18 24 6 21 5 5 5 5 5 2 1 5 5 5 5 5 5 5 5 5 5 5 5 5 5 5 5 5 5 5 5 5 5 5 5 5 5 5 5 5 5 19 3 3 3 3 3 3 18 5 2 1 1 1 5 5 5 5 5 5 5 5 5 5 5 5 5 5 19 3 3 3 3 3 3 3 3 3 3 3 3 3 3 
3 3 3 3 3 3 3 3 3 3 3 3 3 3 3 3 3 18 24 6 21 5 5 5 5 5 1 2 2 1 1 5 5 5 5 5 5 5 5 31 26 26 26 26 26 26 26 26 26 26 5 5 5 5 5 5 5 5 19 3 3 3 3 3 3 18 5 1 1 1 1 2 1 1 1 2 1 1 1 1 2 1 2 1 1 19 3 3 3 3 3 3 3 3 3 3 3 3 3 3 
3 3 3 3 3 3 3 3 3 3 3 3 3 3 3 3 3 18 24 6 21 5 1 1 1 2 1 1 1 1 2 5 5 5 5 5 5 5 5 24 6 6 6 6 6 6 6 6 6 6 5 5 5 5 5 5 5 5 19 3 3 3 3 3 3 18 5 5 2 1 1 1 1 2 1 1 1 2 1 1 1 1 1 1 1 19 3 3 3 3 3 3 3 3 3 3 3 3 3 3 
3 3 3 3 3 3 3 3 3 3 3 3 3 3 3 3 3 18 24 6 21 5 1 1 2 1 1 2 1 1 2 5 5 5 5 5 5 5 5 24 6 20 23 23 23 23 23 23 25 6 5 5 5 5 5 5 5 5 19 3 3 3 3 3 3 18 5 5 1 1 1 5 5 5 5 5 5 5 5 5 5 5 5 1 2 19 3 3 3 3 3 3 3 3 3 3 3 3 3 3 
3 3 3 3 3 3 3 3 3 3 3 3 3 3 3 3 3 18 24 6 21 5 2 1 5 5 5 5 1 1 1 5 5 5 5 5 5 5 5 24 6 21 5 5 5 5 5 5 24 6 26 26 26 26 26 26 26 30 19 3 3 3 3 3 3 18 5 5 1 1 1 5 5 5 5 5 5 5 5 5 5 5 5 1 1 19 3 3 3 3 3 3 3 3 3 3 3 3 3 3 
3 3 3 3 3 3 3 3 3 3 3 3 3 3 3 3 3 18 24 6 21 5 1 1 5 5 5 5 1 2 1 5 5 5 5 5 5 5 5 24 6 21 5 5 5 5 5 5 24 6 6 6 6 6 6 6 6 21 15 13 13 13 13 13 13 17 5 5 2 1 1 1 2 1 1 1 1 1 2 1 1 1 1 2 1 19 3 3 3 3 3 3 3 3 3 3 3 3 3 3 
3 3 3 3 3 3 3 3 3 3 3 3 3 3 3 3 3 18 24 6 21 5 1 2 5 5 5 5 1 1 1 5 5 5 5 5 5 5 5 24 6 21 5 5 5 5 5 5 28 23 23 23 23 23 23 23 23 29 1 2 1 2 2 1 1 2 1 5 1 1 1 1 1 1 1 2 1 1 1 1 1 1 1 1 2 19 3 3 3 3 3 3 3 3 3 3 3 3 3 3 
3 3 3 3 3 3 3 3 3 3 3 3 3 3 3 3 3 18 24 6 21 5 1 2 5 5 5 5 2 1 2 5 5 5 5 5 5 5 5 24 6 21 5 5 5 5 5 5 5 5 5 5 5 5 5 5 5 5 5 5 5 5 5 5 5 5 5 5 1 1 5 5 5 5 5 5 5 5 5 1 2 1 1 1 1 19 3 3 3 3 3 3 3 3 3 3 3 3 3 3 
3 3 3 3 3 3 3 3 3 3 3 3 3 3 3 3 3 18 24 6 21 5 1 1 5 5 5 5 1 1 1 5 5 5 5 31 26 26 26 27 6 21 5 5 5 5 5 5 31 26 26 26 26 26 26 26 26 26 26 26 26 26 26 26 26 1 1 5 1 2 5 5 5 5 5 5 5 5 5 1 1 1 5 5 5 19 3 3 3 3 3 3 3 3 3 3 3 3 3 3 
3 3 3 3 3 3 3 3 3 3 3 3 3 3 32 13 13 17 24 6 21 5 2 1 5 5 5 5 1 1 2 5 5 5 5 24 6 6 6 6 6 21 5 5 5 5 5 5 24 6 6 6 6 6 6 6 6 6 6 6 6 6 6 6 6 21 2 5 1 1 5 5 5 5 5 5 5 5 5 1 1 2 5 5 5 19 3 3 3 3 3 3 3 3 3 3 3 3 3 3 
3 3 3 3 3 3 3 3 3 3 3 3 3 3 18 5 5 5 24 6 21 5 1 1 2 5 5 5 1 2 1 1 1 2 1 28 23 23 23 23 23 29 5 5 5 5 5 5 28 23 23 23 23 23 23 23 23 23 23 23 23 23 25 6 6 21 2 5 2 1 5 5 5 5 5 5 5 5 5 1 1 2 5 5 5 19 3 3 3 3 3 3 3 3 3 3 3 3 3 3 
3 3 3 3 3 3 3 3 3 3 3 3 3 3 18 5 5 5 28 23 29 5 1 2 1 5 5 5 2 1 1 2 1 1 2 2 1 14 12 12 12 12 12 12 12 12 12 12 16 2 14 12 12 12 12 12 12 12 12 12 12 16 24 6 6 21 1 5 1 1 5 5 5 5 5 5 5 5 5 2 1 1 5 5 5 19 3 3 3 3 3 3 3 3 3 3 3 3 3 3 
3 3 3 3 3 3 3 3 3 3 3 3 3 3 18 5 5 5 1 1 1 5 1 2 1 5 5 5 5 5 5 5 5 5 5 5 5 19 3 3 3 3 3 3 3 3 3 3 18 1 19 3 3 3 3 3 3 3 3 3 3 18 24 6 6 21 1 5 1 2 5 5 5 5 5 5 5 5 5 1 2 1 5 5 5 19 3 3 3 3 3 3 3 3 3 3 3 3 3 3 
3 3 3 3 3 3 3 3 3 3 3 3 3 3 18 5 5 5 1 2 1 5 2 31 26 26 30 5 5 5 31 26 30 5 11 11 11 19 3 3 3 3 3 3 3 3 3 3 18 2 19 3 3 3 3 3 3 3 3 3 3 18 24 6 6 21 1 5 1 1 5 5 5 5 5 5 5 5 5 1 2 1 5 5 5 19 3 3 3 3 3 3 3 3 3 3 3 3 3 3 
3 3 3 3 3 3 3 3 3 3 3 3 3 3 18 5 5 5 1 1 1 5 1 24 6 6 21 5 5 5 24 6 21 5 11 4 11 19 3 3 3 3 3 3 3 3 3 3 18 1 19 3 3 3 3 3 3 3 3 3 3 18 24 6 6 21 2 5 1 1 5 5 5 5 5 5 5 5 5 1 1 2 5 5 5 19 3 3 3 3 3 3 3 3 3 3 3 3 3 3 
3 3 3 3 3 3 3 3 3 3 3 3 3 3 18 5 5 5 2 1 1 5 2 28 25 6 21 5 5 5 24 6 21 5 11 4 11 19 3 3 3 3 3 3 3 3 3 3 18 1 19 3 3 3 3 3 3 3 3 3 3 18 24 6 6 21 1 5 1 1 5 5 5 5 5 5 5 5 5 2 1 1 5 5 5 19 3 3 3 3 3 3 3 3 3 3 3 3 3 3 
3 3 3 3 3 3 3 3 3 3 3 3 3 3 18 5 5 5 1 1 2 5 5 5 24 6 21 5 5 5 24 6 21 5 11 4 11 19 3 3 3 3 3 3 3 3 3 3 18 2 19 3 3 3 3 3 3 3 3 3 3 18 24 6 6 21 1 5 2 2 1 2 1 1 1 2 1 7 5 1 1 1 5 5 5 19 3 3 3 3 3 3 3 3 3 3 3 3 3 3 
3 3 3 3 3 3 3 3 3 3 3 3 3 3 18 5 5 5 1 1 1 5 5 5 24 6 21 5 5 5 24 6 21 5 11 6 11 19 3 3 3 3 3 3 3 3 3 3 18 2 19 3 3 3 3 3 3 3 3 3 3 18 24 6 6 21 1 5 1 1 2 1 1 2 1 1 2 1 5 2 1 2 5 5 5 19 3 3 3 3 3 3 3 3 3 3 3 3 3 3 
3 3 3 3 3 3 3 3 3 3 3 3 3 3 18 5 5 5 1 2 1 5 5 5 24 6 21 5 5 5 24 6 21 5 24 6 21 19 3 3 3 3 3 3 3 3 3 3 18 1 19 3 3 3 3 3 3 3 3 3 3 18 24 6 6 21 2 5 5 5 5 5 5 5 5 5 5 5 5 1 2 1 5 5 5 19 3 3 3 3 3 3 3 3 3 3 3 3 3 3 
3 3 3 3 3 3 3 3 3 3 3 3 3 3 18 5 5 5 1 1 1 5 5 5 24 6 21 5 5 5 24 6 21 5 24 6 21 19 3 3 3 3 3 3 3 3 3 3 18 2 19 3 3 3 3 3 3 3 3 3 3 18 24 6 6 21 1 5 5 5 5 5 5 5 5 5 5 5 5 2 1 1 5 5 5 19 3 3 3 3 3 3 3 3 3 3 3 3 3 3 
3 3 3 3 3 3 3 3 3 3 3 3 3 3 18 1 1 1 2 1 2 5 5 5 24 6 21 5 5 5 24 6 21 5 24 6 21 19 3 3 3 3 3 3 3 3 3 3 18 1 19 3 3 3 3 3 3 3 3 3 3 18 24 6 6 21 2 5 5 5 5 5 5 5 5 5 5 5 5 1 2 1 5 5 5 19 3 3 3 3 3 3 3 3 3 3 3 3 3 3 
3 3 3 3 3 3 3 3 3 3 3 3 3 3 18 2 2 1 1 1 2 5 5 5 24 6 21 5 5 5 24 6 21 5 24 6 21 19 3 3 3 3 3 3 3 3 32 13 17 1 15 13 33 3 3 3 3 3 3 3 3 18 24 6 6 21 1 5 5 5 5 5 5 5 5 5 5 5 5 1 1 1 5 5 5 19 3 3 3 3 3 3 3 3 3 3 3 3 3 3 
3 3 3 3 3 3 3 3 3 3 3 3 3 3 18 1 1 1 2 1 1 5 5 5 24 6 21 5 5 5 24 6 21 5 24 6 21 19 3 3 3 3 3 3 3 3 18 2 1 1 2 1 19 3 3 3 3 3 3 3 3 18 24 6 6 21 2 5 5 5 5 5 5 5 5 5 5 5 5 2 1 1 5 5 5 19 3 3 3 3 3 3 3 3 3 3 3 3 3 3 
3 3 3 3 3 3 3 3 3 3 3 3 3 3 18 2 1 5 5 5 5 5 5 5 24 6 21 5 5 5 24 6 21 5 24 6 21 19 3 3 3 3 3 3 3 3 18 1 2 1 1 2 19 3 3 3 3 3 3 3 3 18 24 6 6 21 1 5 5 5 5 5 5 5 5 5 5 5 5 1 2 1 5 5 5 19 3 3 3 3 3 3 3 3 3 3 3 3 3 3 
3 3 3 3 3 3 3 3 3 3 3 3 3 3 18 1 1 5 5 5 5 5 5 5 24 6 21 5 5 5 24 6 21 5 24 6 21 19 3 3 3 3 3 3 3 3 18 1 2 1 1 1 19 3 3 3 3 3 3 3 3 18 24 6 6 21 1 5 5 5 5 5 5 5 5 5 5 5 5 1 2 1 5 5 5 19 3 3 3 3 3 3 3 3 3 3 3 3 3 3 
3 3 3 3 3 3 3 3 3 3 3 3 3 3 18 2 1 5 5 5 5 5 5 5 24 6 22 26 26 26 27 6 21 5 24 6 21 19 3 3 3 3 3 3 3 3 18 2 1 1 2 1 19 3 3 3 3 3 3 3 3 18 24 6 6 21 2 5 5 5 5 5 5 5 5 5 5 5 5 1 1 2 5 5 5 19 3 3 3 3 3 3 3 3 3 3 3 3 3 3 
3 3 3 3 3 3 3 3 3 3 3 3 3 3 18 1 2 5 5 5 5 5 5 5 24 6 6 6 6 6 6 6 21 5 24 6 21 19 3 3 3 3 3 3 3 3 18 1 1 1 2 1 19 3 3 3 3 3 3 3 3 18 24 6 6 21 1 5 5 5 5 5 5 5 5 5 5 5 5 1 2 1 5 5 5 19 3 3 3 3 3 3 3 3 3 3 3 3 3 3 
3 3 3 3 3 3 3 3 3 3 3 3 3 3 18 1 1 5 5 5 5 5 5 5 28 23 23 23 23 23 23 23 29 5 24 6 21 19 3 3 3 3 3 3 3 3 35 12 16 1 14 12 34 3 3 3 3 3 3 3 3 18 24 6 6 21 1 2 5 5 5 5 5 5 5 5 5 5 5 5 1 2 1 1 2 19 3 3 3 3 3 3 3 3 3 3 3 3 3 3 
3 3 3 3 3 3 3 3 3 3 3 3 3 3 18 2 1 5 5 5 5 5 5 5 5 5 5 5 5 5 5 5 5 5 24 6 21 19 3 3 3 3 3 3 3 3 3 3 18 1 19 3 3 3 3 3 3 3 3 3 3 18 28 23 23 29 2 1 2 5 5 5 5 5 5 5 5 5 5 5 5 1 2 1 1 19 3 3 3 3 3 3 3 3 3 3 3 3 3 3 
3 3 3 3 3 3 3 3 3 3 3 3 3 3 18 1 2 31 26 26 26 26 26 26 26 26 26 26 26 26 26 26 26 26 27 6 21 19 3 3 3 3 3 3 3 3 3 3 18 2 19 3 3 3 3 3 3 3 3 3 3 18 5 5 5 1 1 1 1 5 5 5 5 5 5 5 5 5 5 5 5 1 1 1 2 19 3 3 3 3 3 3 3 3 3 3 3 3 3 3 
3 3 3 3 3 3 3 3 3 3 3 3 3 3 18 1 1 24 6 6 6 6 6 6 6 6 6 6 6 6 6 6 6 6 6 6 21 19 3 3 3 3 3 3 3 3 3 3 18 1 19 3 3 3 3 3 3 3 3 3 3 18 5 5 5 2 1 1 1 5 2 2 1 2 1 2 1 1 1 1 2 1 2 1 2 19 3 3 3 3 3 3 3 3 3 3 3 3 3 3 
3 3 3 3 3 3 3 3 3 3 3 3 3 3 18 2 1 28 23 23 23 23 23 23 23 23 23 23 23 23 23 23 23 23 23 23 29 19 3 3 3 3 3 3 3 3 3 3 18 1 19 3 3 3 3 3 3 3 3 3 3 18 5 5 5 2 1 1 2 5 1 2 1 1 1 1 2 1 2 1 1 1 1 2 1 19 3 3 3 3 3 3 3 3 3 3 3 3 3 3 
3 3 3 3 3 3 3 3 3 3 3 3 3 3 18 1 1 5 5 5 5 5 5 5 2 5 5 5 5 5 5 5 5 5 5 5 5 19 3 3 3 3 3 3 3 3 3 3 18 1 19 3 3 3 3 3 3 3 3 3 3 18 5 5 5 1 1 2 1 5 1 1 1 1 2 1 1 1 1 2 1 2 1 1 1 19 3 3 3 3 3 3 3 3 3 3 3 3 3 3 
3 3 3 3 3 3 3 3 3 3 3 3 3 3 18 2 1 5 5 5 5 5 5 5 1 5 5 5 5 5 5 5 5 5 5 5 5 19 3 3 3 3 3 3 3 3 3 3 18 2 19 3 3 3 3 3 3 3 3 3 3 18 5 5 5 1 2 1 1 5 1 2 2 5 5 5 5 5 5 5 5 1 1 1 2 19 3 3 3 3 3 3 3 3 3 3 3 3 3 3 
3 3 3 3 3 3 3 3 3 3 3 3 3 3 18 1 1 5 5 5 5 5 5 5 2 5 5 5 5 5 5 5 5 5 5 5 5 19 3 3 3 3 3 3 3 3 3 3 18 1 19 3 3 3 3 3 3 3 3 3 3 18 5 5 5 1 1 1 2 5 1 1 2 5 5 5 5 5 5 5 5 5 1 1 1 19 3 3 3 3 3 3 3 3 3 3 3 3 3 3 
3 3 3 3 3 3 3 3 3 3 3 3 3 3 18 1 2 5 5 5 5 5 5 5 1 5 5 5 5 5 5 5 5 5 5 5 5 15 13 13 13 13 13 13 13 13 13 13 17 1 15 13 13 13 13 13 13 13 13 13 13 17 5 5 5 1 2 1 1 5 2 1 1 5 5 5 5 5 5 5 5 5 2 2 1 19 3 3 3 3 3 3 3 3 3 3 3 3 3 3 
3 3 3 3 3 3 3 3 3 3 3 3 3 3 18 2 1 5 5 5 5 5 5 5 1 5 5 5 5 5 5 5 5 5 5 5 5 5 5 5 5 5 5 5 5 5 5 5 31 26 30 5 5 5 5 5 5 5 5 5 5 5 5 5 5 2 1 1 1 5 1 2 1 5 5 5 5 5 5 5 5 5 1 1 1 19 3 3 3 3 3 3 3 3 3 3 3 3 3 3 
3 3 3 3 3 3 3 3 3 3 3 3 3 3 18 1 1 5 5 5 5 5 5 5 1 1 1 2 1 2 1 1 2 2 1 1 1 1 2 2 1 1 1 2 1 1 1 5 24 6 21 5 5 5 1 1 1 1 5 5 5 5 5 5 5 2 1 2 1 5 1 1 1 5 2 1 1 2 1 2 1 1 1 1 2 19 3 3 3 3 3 3 3 3 3 3 3 3 3 3 
3 3 3 3 3 3 3 3 3 3 3 3 3 3 18 1 2 5 5 5 5 5 5 5 2 5 5 5 5 5 1 1 1 1 1 1 2 1 1 1 1 2 1 1 1 2 1 5 24 6 21 5 5 5 1 2 5 5 5 5 5 5 5 5 5 1 1 1 1 5 2 1 1 5 1 1 1 1 1 1 2 2 1 2 1 19 3 3 3 3 3 3 3 3 3 3 3 3 3 3 
3 3 3 3 3 3 3 3 3 3 3 3 3 3 18 1 1 5 5 5 5 5 5 5 1 5 5 5 5 5 1 1 5 5 5 5 5 5 5 5 5 5 5 5 1 1 2 5 24 6 21 5 5 5 1 1 5 5 5 5 5 5 5 5 5 2 1 1 2 5 2 1 2 5 1 2 5 5 5 5 5 5 5 5 5 19 3 3 3 3 3 3 3 3 3 3 3 3 3 3 
3 3 3 3 3 3 3 3 3 3 3 3 3 3 18 1 2 5 5 5 5 5 5 5 1 5 5 5 5 5 2 1 5 5 5 5 5 5 5 5 5 5 5 5 2 1 1 5 24 6 21 5 5 5 2 1 5 5 5 5 5 5 5 5 5 1 2 1 1 5 1 1 1 5 2 1 5 5 5 2 2 1 2 1 2 19 3 3 3 3 3 3 3 3 3 3 3 3 3 3 
3 3 3 3 3 3 3 3 3 3 3 3 3 3 18 1 2 5 5 5 5 5 5 5 2 5 5 5 5 5 1 1 5 5 5 5 5 5 5 5 5 5 5 5 1 1 2 5 24 6 21 5 5 5 2 1 5 5 5 5 5 5 5 5 5 1 1 1 1 5 1 2 1 5 1 1 5 5 5 1 1 2 1 1 2 19 3 3 3 3 3 3 3 3 3 3 3 3 3 3 
3 3 3 3 3 3 3 3 3 3 3 3 3 3 18 2 1 5 5 5 5 5 5 5 1 5 5 5 5 5 1 1 1 2 1 1 1 1 1 1 2 2 1 1 1 1 1 5 24 6 21 5 5 5 1 1 5 5 5 5 5 5 5 5 5 1 2 1 2 5 1 1 1 5 1 2 5 5 5 2 1 1 1 1 1 19 3 3 3 3 3 3 3 3 3 3 3 3 3 3 
3 3 3 3 3 3 3 3 3 3 3 3 3 3 18 1 1 5 5 5 5 5 5 5 7 5 5 5 5 5 2 1 2 1 1 1 2 1 1 1 1 1 1 1 1 2 1 5 24 6 21 5 5 5 1 2 5 5 5 5 5 5 5 5 5 2 1 1 2 5 1 1 1 1 1 1 5 5 5 1 1 2 2 1 2 19 3 3 3 3 3 3 3 3 3 3 3 3 3 3 
3 3 3 3 3 3 3 3 3 3 3 3 3 3 18 1 2 5 5 5 5 5 5 5 5 5 5 5 5 5 5 5 1 1 5 5 5 5 5 5 5 5 5 5 5 1 1 5 24 6 21 5 5 5 1 1 5 5 5 5 5 5 5 5 5 1 1 1 2 5 1 2 2 2 1 1 5 5 5 5 5 5 5 1 2 19 3 3 3 3 3 3 3 3 3 3 3 3 3 3 
3 3 3 3 3 3 3 3 3 3 3 3 3 3 18 2 1 5 5 5 5 5 5 5 5 5 5 5 5 5 5 5 1 2 5 5 5 5 5 1 1 2 1 1 1 2 1 5 28 23 29 5 5 5 2 1 5 5 5 5 5 5 5 5 5 1 2 1 1 1 2 1 1 1 1 1 5 5 5 2 1 1 5 1 1 19 3 3 3 3 3 3 3 3 3 3 3 3 3 3 
3 3 3 3 3 3 3 3 3 3 3 3 3 3 18 1 1 5 5 5 5 5 5 5 5 5 5 5 5 5 5 5 2 1 5 5 31 26 30 1 1 1 1 1 1 1 1 5 5 1 5 5 5 5 1 1 5 5 5 5 5 5 5 5 5 1 1 2 2 1 1 1 1 5 5 5 5 5 5 1 1 2 5 2 1 19 3 3 3 3 3 3 3 3 3 3 3 3 3 3 
3 3 3 3 3 3 3 3 3 3 3 3 3 3 18 1 2 5 5 5 5 5 5 5 5 5 5 5 5 5 5 5 2 1 5 5 24 6 21 2 5 5 5 5 5 1 1 5 5 2 1 2 1 1 1 2 1 1 1 1 1 1 1 2 5 2 1 1 1 1 1 2 1 5 5 5 5 5 5 1 2 1 5 1 1 19 3 3 3 3 3 3 3 3 3 3 3 3 3 3 
3 3 3 3 3 3 3 3 3 3 3 3 3 3 18 1 1 5 5 5 5 5 5 5 5 5 5 5 5 5 5 5 2 1 5 5 24 6 21 1 5 1 2 1 1 1 1 5 5 1 1 1 2 1 1 1 1 1 2 1 2 1 1 1 5 1 1 2 1 2 1 1 1 1 1 1 1 1 1 2 1 1 5 1 2 19 3 3 3 3 3 3 3 3 3 3 3 3 3 3 
3 3 3 3 3 3 3 3 3 3 3 3 3 3 18 31 26 26 26 2 5 5 5 5 5 5 5 5 5 5 5 5 1 1 5 5 24 6 21 2 5 1 1 1 2 2 1 5 5 2 1 2 1 2 1 1 1 2 1 1 1 1 1 1 5 5 5 5 5 5 5 5 5 5 5 5 5 5 5 5 5 5 5 1 1 19 3 3 3 3 3 3 3 3 3 3 3 3 3 3 
3 3 3 3 3 3 3 3 3 3 3 3 3 3 18 24 6 6 6 21 5 5 5 5 5 5 5 5 5 5 5 5 5 5 5 5 24 6 21 2 5 2 1 1 1 1 1 5 5 5 5 5 5 5 5 5 5 1 1 2 1 2 1 1 1 1 1 1 1 2 1 1 1 1 1 1 1 1 1 1 1 1 2 2 1 19 3 3 3 3 3 3 3 3 3 3 3 3 3 3 
3 3 3 3 3 3 3 3 3 3 3 3 3 3 18 28 23 25 6 21 5 5 5 5 5 5 5 5 5 5 5 5 5 5 5 5 24 6 21 5 5 5 5 2 5 5 5 5 11 11 11 11 11 11 11 11 5 1 1 1 1 1 2 1 2 1 1 1 1 2 2 1 1 2 1 1 2 1 1 2 1 1 1 1 1 19 3 3 3 3 3 3 3 3 3 3 3 3 3 3 
3 3 3 3 3 3 3 3 3 3 3 3 3 3 18 5 5 24 6 21 5 5 5 5 5 5 5 5 5 5 5 5 5 5 5 5 24 6 21 5 5 5 5 1 5 5 5 5 11 4 4 4 4 4 4 11 5 1 5 5 5 5 5 5 1 1 1 2 1 1 1 1 1 1 2 1 1 1 1 1 1 2 1 1 2 19 3 3 3 3 3 3 3 3 3 3 3 3 3 3 
3 3 3 3 3 3 3 3 3 3 3 3 3 3 18 5 5 24 6 21 5 5 5 5 5 5 5 5 5 5 5 5 5 5 5 5 24 6 21 5 5 5 5 2 5 5 5 5 11 4 4 4 4 4 4 11 5 1 1 2 1 1 2 5 1 1 2 1 1 1 1 2 1 1 1 1 1 2 1 2 1 1 1 2 1 19 3 3 3 3 3 3 3 3 3 3 3 3 3 3 
3 3 3 3 3 3 3 3 3 3 3 3 3 3 18 5 5 24 6 21 5 5 5 5 5 5 5 5 5 5 5 5 5 5 5 5 24 6 21 5 5 5 5 1 5 5 5 5 11 4 4 4 4 4 4 11 5 2 1 1 1 2 1 5 5 5 5 5 5 5 5 5 5 5 5 5 5 5 5 5 5 5 5 5 2 19 3 3 3 3 3 3 3 3 3 3 3 3 3 3 
3 3 3 3 3 3 3 3 3 3 3 3 3 3 18 5 5 24 6 21 5 5 5 5 5 5 5 5 5 5 5 5 5 5 5 5 24 6 21 5 5 5 5 1 1 5 5 5 11 4 4 4 4 4 4 11 5 1 1 2 1 1 1 1 5 5 5 5 5 5 5 5 5 5 5 5 5 5 5 5 5 5 5 5 1 19 3 3 3 3 3 3 3 3 3 3 3 3 3 3 
3 3 3 3 3 3 3 3 3 3 3 3 3 3 18 5 5 24 6 21 5 5 5 5 5 5 5 5 5 5 5 5 5 5 5 5 24 6 21 5 5 5 5 5 2 5 5 5 11 4 4 4 4 4 4 11 5 1 2 1 1 2 1 7 5 1 2 1 2 1 1 2 2 1 1 1 2 1 2 1 1 2 1 1 2 19 3 3 3 3 3 3 3 3 3 3 3 3 3 3 
3 3 3 3 3 3 3 3 3 3 3 3 3 3 18 5 5 24 6 21 5 5 5 5 5 5 5 5 5 5 5 5 5 5 5 5 24 6 21 5 5 5 5 5 1 5 5 5 11 4 4 4 4 4 4 11 5 5 5 5 5 5 5 5 5 1 5 5 5 5 5 5 5 5 5 11 11 11 11 11 11 11 11 11 11 19 3 3 3 3 3 3 3 3 3 3 3 3 3 3 
3 3 3 3 3 3 3 3 3 3 3 3 3 3 18 5 5 24 6 21 2 5 5 5 5 5 5 5 5 5 5 5 5 5 5 5 24 6 21 5 5 5 5 5 5 5 5 5 11 4 4 4 4 4 4 11 5 5 5 5 5 5 5 5 5 1 5 5 5 5 5 5 5 5 5 11 2 2 2 2 2 2 2 2 11 19 3 3 3 3 3 3 3 3 3 3 3 3 3 3 
3 3 3 3 3 3 3 3 3 3 3 3 3 3 18 5 5 24 6 21 2 31 26 26 26 26 26 26 26 26 26 26 26 26 26 26 27 6 22 26 26 30 5 5 5 5 5 5 11 11 11 11 11 11 1 11 5 5 5 5 5 5 5 5 5 1 5 5 5 5 5 5 5 5 5 11 2 2 2 2 2 2 2 2 11 19 3 3 3 3 3 3 3 3 3 3 3 3 3 3 
3 3 3 3 3 3 3 3 3 3 3 3 3 3 18 2 1 24 6 22 26 27 6 6 6 6 6 6 6 6 6 6 6 6 6 6 6 6 6 6 6 21 5 5 5 5 5 5 5 5 5 5 5 31 26 30 5 5 5 5 5 5 5 5 5 1 2 1 1 2 1 1 1 1 2 11 2 2 2 2 2 2 2 2 11 19 3 3 3 3 3 3 3 3 3 3 3 3 3 3 
3 3 3 3 3 3 3 3 3 3 3 3 3 3 18 1 1 24 6 6 6 6 20 23 23 23 23 23 23 23 23 23 23 23 23 23 23 23 23 23 23 29 5 5 5 5 5 5 5 26 26 26 26 27 6 21 5 5 5 5 5 5 5 5 5 1 2 1 1 1 1 2 2 1 1 1 2 2 2 2 2 2 2 2 11 19 3 3 3 3 3 3 3 3 3 3 3 3 3 3 
3 3 3 3 3 3 3 3 3 3 3 3 3 3 18 2 2 28 25 6 6 20 5 5 5 5 5 5 5 5 5 5 5 5 5 5 5 5 5 5 5 1 1 2 1 1 1 2 24 6 6 6 6 6 6 21 5 5 5 5 5 5 5 5 5 1 1 2 1 2 1 1 1 1 2 11 2 2 2 2 2 2 2 2 11 19 3 3 3 3 3 3 3 3 3 3 3 3 3 3 
3 3 3 3 3 3 3 3 3 3 3 3 3 3 18 1 1 1 28 23 23 5 5 5 5 5 5 5 5 5 5 5 5 5 5 5 5 5 5 5 5 1 1 1 2 1 1 1 28 23 23 23 23 23 23 29 5 5 5 5 5 5 5 5 5 5 5 5 5 5 5 5 5 5 5 11 2 2 2 2 2 2 2 2 11 19 3 3 3 3 3 3 3 3 3 3 3 3 3 3 
3 3 3 3 3 3 3 3 3 3 3 3 3 3 18 1 2 1 2 1 1 5 5 5 5 5 5 5 5 5 5 5 5 5 5 5 5 5 5 5 5 1 2 1 1 1 1 1 14 12 12 12 12 12 12 12 12 12 12 12 12 12 12 12 12 16 5 5 5 5 5 5 5 5 5 11 2 2 2 2 2 2 2 2 11 19 3 3 3 3 3 3 3 3 3 3 3 3 3 3 
3 3 3 3 3 3 3 3 3 3 3 3 3 3 18 1 1 2 1 1 2 5 5 5 5 5 5 5 5 5 5 5 5 5 5 5 5 5 5 5 5 2 1 2 1 1 2 1 19 3 3 3 3 3 3 3 3 3 3 3 3 3 3 3 3 18 5 5 5 5 5 5 5 5 5 11 11 11 11 11 11 11 11 11 11 19 3 3 3 3 3 3 3 3 3 3 3 3 3 3 
3 3 3 3 3 3 3 3 3 3 3 3 3 3 35 12 12 12 12 12 12 12 12 12 12 12 12 12 12 12 12 12 12 12 12 12 12 12 12 12 12 12 12 12 12 12 12 12 34 3 3 3 3 3 3 3 3 3 3 3 3 3 3 3 3 35 12 12 12 12 12 12 12 12 12 12 12 12 12 12 12 12 12 12 12 34 3 3 3 3 3 3 3 3 3 3 3 3 3 3 
3 3 3 3 3 3 3 3 3 3 3 3 3 3 3 3 3 3 3 3 3 3 3 3 3 3 3 3 3 3 3 3 3 3 3 3 3 3 3 3 3 3 3 3 3 3 3 3 3 3 3 3 3 3 3 3 3 3 3 3 3 3 3 3 3 3 3 3 3 3 3 3 3 3 3 3 3 3 3 3 3 3 3 3 3 3 3 3 3 3 3 3 3 3 3 3 3 3 3 3 
3 3 3 3 3 3 3 3 3 3 3 3 3 3 3 3 3 3 3 3 3 3 3 3 3 3 3 3 3 3 3 3 3 3 3 3 3 3 3 3 3 3 3 3 3 3 3 3 3 3 3 3 3 3 3 3 3 3 3 3 3 3 3 3 3 3 3 3 3 3 3 3 3 3 3 3 3 3 3 3 3 3 3 3 3 3 3 3 3 3 3 3 3 3 3 3 3 3 3 3 
3 3 3 3 3 3 3 3 3 3 3 3 3 3 3 3 3 3 3 3 3 3 3 3 3 3 3 3 3 3 3 3 3 3 3 3 3 3 3 3 3 3 3 3 3 3 3 3 3 3 3 3 3 3 3 3 3 3 3 3 3 3 3 3 3 3 3 3 3 3 3 3 3 3 3 3 3 3 3 3 3 3 3 3 3 3 3 3 3 3 3 3 3 3 3 3 3 3 3 3 
3 3 3 3 3 3 3 3 3 3 3 3 3 3 3 3 3 3 3 3 3 3 3 3 3 3 3 3 3 3 3 3 3 3 3 3 3 3 3 3 3 3 3 3 3 3 3 3 3 3 3 3 3 3 3 3 3 3 3 3 3 3 3 3 3 3 3 3 3 3 3 3 3 3 3 3 3 3 3 3 3 3 3 3 3 3 3 3 3 3 3 3 3 3 3 3 3 3 3 3 
3 3 3 3 3 3 3 3 3 3 3 3 3 3 3 3 3 3 3 3 3 3 3 3 3 3 3 3 3 3 3 3 3 3 3 3 3 3 3 3 3 3 3 3 3 3 3 3 3 3 3 3 3 3 3 3 3 3 3 3 3 3 3 3 3 3 3 3 3 3 3 3 3 3 3 3 3 3 3 3 3 3 3 3 3 3 3 3 3 3 3 3 3 3 3 3 3 3 3 3 
3 3 3 3 3 3 3 3 3 3 3 3 3 3 3 3 3 3 3 3 3 3 3 3 3 3 3 3 3 3 3 3 3 3 3 3 3 3 3 3 3 3 3 3 3 3 3 3 3 3 3 3 3 3 3 3 3 3 3 3 3 3 3 3 3 3 3 3 3 3 3 3 3 3 3 3 3 3 3 3 3 3 3 3 3 3 3 3 3 3 3 3 3 3 3 3 3 3 3 3 
3 3 3 3 3 3 3 3 3 3 3 3 3 3 3 3 3 3 3 3 3 3 3 3 3 3 3 3 3 3 3 3 3 3 3 3 3 3 3 3 3 3 3 3 3 3 3 3 3 3 3 3 3 3 3 3 3 3 3 3 3 3 3 3 3 3 3 3 3 3 3 3 3 3 3 3 3 3 3 3 3 3 3 3 3 3 3 3 3 3 3 3 3 3 3 3 3 3 3 3 
